# # # # # # # # # # #
# . . / . . # . . . #
. . # # # . # # # . #
# . . . . . 2 . . / #
# . # . . . # . # # 1
# . . . . . # . . . #
# # # # # # # . # # #
# . . . . . # . . . #
# . . . # . # . # . #
# / . . . . # . . . #
# # # # # # # #.# # 