      ####   ####   ####   ####   ####   ####   ####   ####   ####   ####   ####

      ####      .      .      .      .      .      .      .   ####      .   ####

      ####   ####   ####      .   ####   ####   ####      .   ####      .   ####

      ####      .      .      .   ####      .      .      .      .      .   ####

      ####   ####   ####      .   ####   ####   ####      .   ####      .   ####

      ####      /      .      .   ####      .      .      .   ####      .   ####

      ####   ####   ####      .   ####      .   ####   ####   ####      #   ####

      ####      .      .      .   ####      .      .      .   ####      /   

      ####   ####   ####   ####   ####      .   ####      .   ####      .   ####

      ####      .      .      .      .      .   ####      .   ####      .   ####

      ####   ####   ####   ####   ####   ####   ####   ####   ####   ####   ####