12345678911
    # / # . . . # . # . #
    # # # # # . # . # . #
    # . . . . . . . . . #
    # # # . # . # # # . #
    # . . . # . # . # . #
    # # # . # . # . # . #
    # . . . # . # . # . #
    # # # . # . # . # . #
    # / . . # . # . . . #
    # # # . # # # # # # #