# # # # # # # # # # # 
# . . / . . . . . . # 
# . # . # # # . # . # 
# . . . . . . . # . # 
# . # # . . . . # . # 
# . . . . . . . . . # 
# # # # # # # . # . # 
# . . . . . # . # . # 
# . # # # . # . . . # 
# . . . # . . . . / # 
# # # # # # # # # # # 
