# # # # # # # # # # # # # # # # # # # # # # # # # 
# . . . . . . . . . . . . . . . . . . . # . . . # 
# . # # # # # # # . # . # # # . # . # . # # # . # 
# . # . . . . . . . # . . . # . # . # . . . . . # 
# . # . # # # . # . # # # . # . # . # . # # # # # 
# . . . # . . . # . # . # . # . # . # . . . . . # 
# . # # # . # . # . # . # . # . # . # # # # # . # 
# . . . # . # . # . # . . . # . # . . . . . . . # 
# . # # # . # . # . # # # . # # # . # . # . # # # 
# . . . # . # . # . # . . . # . . . # . # . # / # 
# . # . # . # . # . # # # . # # # . # . # . # . # 
# . # . # . # . # . # . . . # . . . # . # . # . # 
# . # . # . # # # . # . # # # . # # # # # . # . # 
# . # . # . # . . . # . # . # . . . # . . . . . # 
# . # . # . # # # . # . # . # . # # # . # # # . # 
# / # . # . # . . . # . . . # . . . . . # . . . # 
# . # . # . # . # # # . # # # . # # # . # . # . # 
# . # . # . # . . . # . # . # . # . . . # . # . # 
# . # . # # # . # # # . # . # . # . # . # # # . # 
# . # . # . . . . . # . . . # . # . # . # . . . # 
# . # . # # # . # . # # # . # . # . # . # . # # # 
# . . . # . . . # . # . # . . . # . # . # . . . # 
# # # . # . # # # . # . # . # # # . # . # . # . # 
# . . . # . # . . . . . . . . . # . # . # . # . # 
# # # # # # # # # # # # # # # # # # # # # # # # # 
