  ####  ####  ####  ####  ####  ####  ####  ####  ####  ####  ####

  ####     .     .     .  ####     /     .     .     .     .  ####

  ####  ####  ####     .  ####  ####  ####     .  ####     .  ####

  ####     .     .     .     .     .     .     .  ####     .  ####

  ####     .  ####  ####  ####     .  ####  ####  ####     .  ####

  ####     .  ####     .     .     .  ####     .  ####     .  ####

  ####     .  ####  ####  ####     .  ####     .  ####     .  ####

  ####     .     .     .     .     .     .     .  ####     .  ####

  ####     .  ####  ####  ####  ####  ####     .  ####     .  ####

  ####     .     .     .  ####     .     .     /  ####     .  ####

  ####  ####  ####  ####  ####  ####  ####  ####  ####  ####  ####

