  ####  ####  ####  ####  ####  ####  ####  ####  ####  ####  ####

  ####     .     .     .     .     .  ####     .  ####     /  ####

  ####     .  ####  ####  ####     .  ####     .  ####     .  ####

  ####     .  ####     .     .     .     .     .  ####     .  ####

  ####     .  ####     .  ####  ####  ####     .  ####     .  ####

  ####     .     .     .     .     .  ####     .     .     .  ####

  ####     .  ####     .  ####     .  ####     .  ####     .  ####

  ####     .  ####     .  ####     .  ####     .  ####     .  ####

  ####     .  ####     .  ####     .  ####  ####  ####     .  ####

  ####     .  ####     .  ####     .     .     /  ####     .  ####

  ####  ####  ####  ####  ####  ####  ####  ####  ####  ####  ####

  ####  ####  ####  ####  ####  ####  ####  ####  ####  ####  ####

  ####     .     .     .     .     .     .     .     .     /  ####

  ####     .  ####  ####  ####  ####  ####  ####  ####  ####  ####

  ####     .  ####     .     .     .     .     .     .     .  ####

  ####     .  ####     .  ####  ####  ####     .  ####  ####  ####

  ####     .  ####     .  ####     .     .     .     .     .  ####

  ####     .  ####     .  ####     .  ####     .  ####     .  ####

  ####     .     .     .  ####     .  ####     .  ####     .  ####

  ####  ####  ####     .  ####     .  ####     .  ####     .  ####

  ####     .     .     .  ####     .  ####     .  ####     /  ####

  ####  ####  ####  ####  ####  ####  ####  ####  ####  ####  ####

